Actor ZombiePlasmaBallMOP : ZombiePlasmaBall replaces ZombiePlasmaBall { DamageType "Monster" }
Actor ZDemonTechProjectileMOP : ZDemonTechProjectile replaces ZDemonTechProjectile { DamageType "Monster" }
Actor ZombieRocketMOP : ZombieRocket replaces ZombieRocket { DamageType "Monster" }
Actor NewImpBallMOP : NewImpBall replaces NewImpBall { DamageType "Monster" }
Actor NightBallMOP : NightBall replaces NightBall { DamageType "Monster" }
Actor DevilBallMOP : DevilBall replaces DevilBall { DamageType "Monster" }
Actor PhaseImpBallMOP : PhaseImpBall replaces PhaseImpBall { DamageType "Monster" }
Actor PinkyLungeMOP : PinkyLunge replaces PinkyLunge { DamageType "Monster" }
Actor MagmaBallMOP : MagmaBall replaces MagmaBall { DamageType "Monster" }
Actor DTFDemonTechProjectileMOP : DTFDemonTechProjectile replaces DTFDemonTechProjectile { DamageType "Monster" }
Actor SoulBallMOP : SoulBall replaces SoulBall { DamageType "Monster" }
Actor PoisonSoulCloudMOP : PoisonSoulCloud replaces PoisonSoulCloud { DamageType "Monster" }
Actor PSoulDeathCloudMOP : PSoulDeathCloud replaces PSoulDeathCloud { DamageType "Monster" }
Actor MagmaBreathMOP : MagmaBreath replaces MagmaBreath { DamageType "Monster" }
Actor RictusBallMOP : RictusBall replaces RictusBall { DamageType "Monster" }
Actor RictusSuicideMOP : RictusSuicide replaces RictusSuicide { DamageType "Monster" }
Actor ABBallMOP : ABBall replaces ABBall { DamageType "Monster" }
Actor WatcherBallMOP : WatcherBall replaces WatcherBall { DamageType "Monster" }
Actor WatcherTracerMOP : WatcherTracer replaces WatcherTracer { DamageType "Monster" }
Actor HadesBallMOP : HadesBall replaces HadesBall { DamageType "Monster" }
Actor HeleBallMOP : HeleBall replaces HeleBall { DamageType "Monster" }
Actor SKBallMOP : SKBall replaces SKBall { DamageType "Monster" }
Actor DefilerBallMOP : DefilerBall replaces DefilerBall { DamageType "Monster" }
Actor PoisonEleBreathMOP : PoisonEleBreath replaces PoisonEleBreath { DamageType "Monster" }
Actor BombBallMOP : BombBall replaces BombBall { DamageType "Monster" }
Actor BombBreathMOP : BombBreath replaces BombBreath { DamageType "Monster" }
Actor BombSuicideMOP : BombSuicide replaces BombSuicide { DamageType "Monster" }
Actor HectebusBallMOP : HectebusBall replaces HectebusBall { DamageType "Monster" }
Actor HectebusFlamethrowerMOP : HectebusFlamethrower replaces HectebusFlamethrower { DamageType "Monster" }
Actor DaedabusBallMOP : DaedabusBall replaces DaedabusBall { DamageType "Monster" }
Actor DaedabusChemSprayMOP : DaedabusChemSpray replaces DaedabusChemSpray { DamageType "Monster" }
Actor BarbatosPoisonMOP : BarbatosPoison replaces BarbatosPoison { DamageType "Monster" }
Actor DualaPlasmaMOP : DualaPlasma replaces DualaPlasma { DamageType "Monster" }
Actor FusionShotMOP : FusionShot replaces FusionShot { DamageType "Monster" }
Actor FusioniteRailPuffMOP : FusioniteRailPuff replaces FusioniteRailPuff { DamageType "Monster" }
Actor BabyPuffMOP : BabyPuff replaces BabyPuff { DamageType "Monster" }
Actor BabyDemo15KMOP : BabyDemo15K replaces BabyDemo15K { DamageType "Monster" }
Actor BabySent10KMOP : BabySent10K replaces BabySent10K { DamageType "Monster" }
Actor BabySentRed10KExMOP : BabySentRed10KEx replaces BabySentRed10KEx { DamageType "Monster" }
Actor GuardianTracerMOP : GuardianTracer replaces GuardianTracer { DamageType "Monster" }
Actor CadaverRocketMOP : CadaverRocket replaces CadaverRocket { DamageType "Monster" }
Actor HellfireRocketMOP : HellfireRocket replaces HellfireRocket { DamageType "Monster" }
Actor FamineDashPunchMOP : FamineDashPunch replaces FamineDashPunch { DamageType "Monster" }
Actor FamineTracerMOP : FamineTracer replaces FamineTracer { DamageType "Monster" }
Actor KnightFastBallMOP : KnightFastBall replaces KnightFastBall { DamageType "Monster" }
Actor PBallMOP : PBall replaces PBall { DamageType "Monster" }
Actor PyroFireMOP : PyroFire replaces PyroFire { DamageType "Monster" }
Actor PyroFireSpawnerMOP : PyroFireSpawner replaces PyroFireSpawner { DamageType "Monster" }
Actor CyNoblePuffMOP : CyNoblePuff replaces CyNoblePuff { DamageType "Monster" }
Actor CyNobleBallMOP : CyNobleBall replaces CyNobleBall { DamageType "Monster" }
Actor CyNobleRocketMOP : CyNobleRocket replaces CyNobleRocket { DamageType "Monster" }
Actor DukeFireSpawnerMOP : DukeFireSpawner replaces DukeFireSpawner { DamageType "Monster" }
Actor DukeFireMOP : DukeFire replaces DukeFire { DamageType "Monster" }
Actor DukeSpikeMOP : DukeSpike replaces DukeSpike { DamageType "Monster" }
Actor BBallMOP : BBall replaces BBall { DamageType "Monster" }
Actor BBall2MOP : BBall2 replaces BBall2 { DamageType "Monster" }
Actor DukeBall2MOP : DukeBall2 replaces DukeBall2 { DamageType "Monster" }
Actor CometMOP : Comet replaces Comet { DamageType "Monster" }
Actor BehemothCometMOP : BehemothComet replaces BehemothComet { DamageType "Monster" }
Actor BehemothSeekingCometMOP : BehemothSeekingComet replaces BehemothSeekingComet { DamageType "Monster" }
Actor BarbatosCometMOP : BarbatosComet replaces BarbatosComet { DamageType "Monster" }
Actor HDCometMOP : HDComet replaces HDComet { DamageType "Monster" }
Actor CacoMCometMOP : CacoMComet replaces CacoMComet { DamageType "Monster" }
Actor PyroCometMOP : PyroComet replaces PyroComet { DamageType "Monster" }
Actor BruiserRailPuffMOP : BruiserRailPuff replaces BruiserRailPuff { DamageType "Monster" }
Actor BruiserMissileMOP : BruiserMissile replaces BruiserMissile { DamageType "Monster" }
Actor Cybruiser15KMOP : Cybruiser15K replaces Cybruiser15K { DamageType "Monster" }
Actor IFireMOP : IFire replaces IFire { DamageType "Monster" }
Actor HellionSmokeAttackMOP : HellionSmokeAttack replaces HellionSmokeAttack { DamageType "Monster" }
Actor SpiderBFG9500BallMOP : SpiderBFG9500Ball replaces SpiderBFG9500Ball { DamageType "Monster" }
Actor Spider15KMOP : Spider15K replaces Spider15K { DamageType "Monster" }
Actor DarkDemo10KMOP : DarkDemo10K replaces DarkDemo10K { DamageType "Monster" }
Actor DarkDemo10KExMOP : DarkDemo10KEx replaces DarkDemo10KEx { DamageType "Monster" }
Actor SentientBFG9500BallMOP : SentientBFG9500Ball replaces SentientBFG9500Ball { DamageType "Monster" }
Actor Sentient10KMOP : Sentient10K replaces Sentient10K { DamageType "Monster" }
Actor SentientRed10KExMOP : SentientRed10KEx replaces SentientRed10KEx { DamageType "Monster" }
Actor SentientDTBFG10KBallMOP : SentientDTBFG10KBall replaces SentientDTBFG10KBall { DamageType "Monster" }
Actor SentientDTBFGProjectileAttackMOP : SentientDTBFGProjectileAttack replaces SentientDTBFGProjectileAttack { DamageType "Monster" }
Actor CyberLordRocketMOP : CyberLordRocket replaces CyberLordRocket { DamageType "Monster" }
Actor CyberLordHomerMOP : CyberLordHomer replaces CyberLordHomer { DamageType "Monster" }
Actor CyberLordGrenadeMOP : CyberLordGrenade replaces CyberLordGrenade { DamageType "Monster" }
Actor DarkCyberRocketMOP : DarkCyberRocket replaces DarkCyberRocket { DamageType "Monster" }
Actor DarkCyberHomerMOP : DarkCyberHomer replaces DarkCyberHomer { DamageType "Monster" }
Actor DarkCyberFireMOP : DarkCyberFire replaces DarkCyberFire { DamageType "Monster" }
Actor DarkCyberRailMOP : DarkCyberRail replaces DarkCyberRail { DamageType "Monster" }
Actor DarkCyber15KMOP : DarkCyber15K replaces DarkCyber15K { DamageType "Monster" }
Actor RainCometSpawnerMOP : RainCometSpawner replaces RainCometSpawner { DamageType "Monster" }
Actor RainCometMOP : RainComet replaces RainComet { DamageType "Monster" }
Actor CardinalRocketMOP : CardinalRocket replaces CardinalRocket { DamageType "Monster" }
Actor CardinalHomingRocketMOP : CardinalHomingRocket replaces CardinalHomingRocket { DamageType "Monster" }
Actor CardinalRailMOP : CardinalRail replaces CardinalRail { DamageType "Monster" }
Actor CardinalDTBFG10KBallMOP : CardinalDTBFG10KBall replaces CardinalDTBFG10KBall { DamageType "Monster" }
Actor CardinalDTBFGProjectileAttackMOP : CardinalDTBFGProjectileAttack replaces CardinalDTBFGProjectileAttack { DamageType "Monster" }
Actor Cardinal10KMOP : Cardinal10K replaces Cardinal10K { DamageType "Monster" }
Actor CardinalRed10KExMOP : CardinalRed10KEx replaces CardinalRed10KEx { DamageType "Monster" }
Actor DTBFG10KTracerMindMOP : DTBFG10KTracerMind replaces DTBFG10KTracerMind { DamageType "Monster" }
Actor DTBFG10KTracerCyberMOP : DTBFG10KTracerCyber replaces DTBFG10KTracerCyber { DamageType "Monster" }
